Country_Code,Country_Name,Market_Year,Arabica_Production,Robusta_Production,Other_Production,Total_Production,Bean_Exports,Roast_Ground_Exports,Soluble_Exports,Total_Exports,Bean_Imports,Roast_Ground_Imports,Soluble_Imports,Total_Imports,Roast_Ground_consumption,Soluble_consumption,Total_consumption
AG,Algeria,2017,0,0,0,0,0,0,0,0,129900,0,2400,132300,129900,2400,132300
AG,Algeria,2018,0,0,0,0,0,0,0,0,136200,0,1800,138000,136200,1800,138000
AG,Algeria,2019,0,0,0,0,0,0,0,0,138000,0,2400,140400,138000,2400,140400
AG,Algeria,2020,0,0,0,0,0,0,0,0,120000,0,2400,122400,120000,2400,122400
AG,Algeria,2021,0,0,0,0,0,0,0,0,132000,0,2400,134400,132000,2400,134400
AG,Algeria,2022,0,0,0,0,0,0,0,0,123000,0,2400,125400,123000,2400,125400
AG,Algeria,2023,0,0,0,0,0,0,0,0,120000,0,3000,123000,120000,3000,123000
AO,Angola,2017,0,1200,0,1200,360,0,0,360,0,0,0,0,840,0,840
AO,Angola,2018,0,1140,0,1140,360,0,0,360,0,0,0,0,780,0,780
AO,Angola,2019,0,1200,0,1200,480,0,0,480,0,0,0,0,720,0,720
AO,Angola,2020,0,1920,0,1920,1320,0,0,1320,0,0,0,0,600,0,600
AO,Angola,2021,0,1800,0,1800,960,0,0,960,0,0,0,0,840,0,840
AO,Angola,2022,0,1500,0,1500,960,0,0,960,0,0,0,0,540,0,540
AO,Angola,2023,0,1800,0,1800,1200,0,0,1200,0,0,0,0,600,0,600
AR,Argentina,2017,0,0,0,0,0,0,0,0,29400,1140,14700,45240,30540,14700,45240
AR,Argentina,2018,0,0,0,0,0,0,0,0,27000,1500,18000,46500,28500,18000,46500
AR,Argentina,2019,0,0,0,0,0,0,0,0,27000,1500,15600,44100,28500,15600,44100
AR,Argentina,2020,0,0,0,0,0,0,0,0,31500,1440,18600,51540,32940,18600,51540
AR,Argentina,2021,0,0,0,0,0,0,0,0,24600,1740,21000,47340,29340,18000,47340
AR,Argentina,2022,0,0,0,0,0,0,0,0,26100,1500,21000,48600,27000,21600,48600
AR,Argentina,2023,0,0,0,0,0,0,0,0,27000,1500,22500,51000,27000,24000,51000
AS,Australia,2017,0,0,0,0,0,0,0,0,84900,11400,7500,103800,96300,7500,103800
AS,Australia,2018,0,0,0,0,0,0,0,0,92400,9600,12000,114000,102000,12000,114000
AS,Australia,2019,0,0,0,0,0,0,0,0,96600,9900,15900,122400,106500,15900,122400
AS,Australia,2020,0,0,0,0,0,0,0,0,84900,12000,20700,117600,95100,22500,117600
AS,Australia,2021,0,0,0,0,0,0,0,0,98400,12300,12600,123300,110700,12600,123300
AS,Australia,2022,0,0,0,0,0,0,0,0,96000,12000,19500,127500,108000,19500,127500
AS,Australia,2023,0,0,0,0,0,0,0,0,99000,12000,21000,132000,111000,21000,132000
BL,Bolivia,2017,4500,0,0,4500,1260,0,0,1260,0,0,0,0,3240,0,3240
BL,Bolivia,2018,5100,0,0,5100,1500,0,0,1500,0,0,0,0,3600,0,3600
BL,Bolivia,2019,5100,0,0,5100,1380,0,0,1380,0,0,0,0,3720,0,3720
BL,Bolivia,2020,5100,0,0,5100,1320,0,0,1320,0,0,0,0,3780,0,3780
BL,Bolivia,2021,4800,0,0,4800,1380,0,0,1380,0,0,0,0,3420,0,3420
BL,Bolivia,2022,5100,0,0,5100,1860,0,0,1860,0,0,0,0,3240,0,3240
BL,Bolivia,2023,4800,0,0,4800,1800,0,0,1800,0,0,0,0,3000,0,3000
BR,Brazil,2017,2736000,630000,0,3366000,1759500,1860,223500,1984860,0,3720,0,3720,1230000,67500,1297500
BR,Brazil,2018,2370000,756000,0,3126000,1616280,1200,209760,1827240,0,3660,0,3660,1276500,68700,1345200
BR,Brazil,2019,2982000,1008000,0,3990000,2242740,1440,241380,2485560,0,4020,0,4020,1321200,70800,1392000
BR,Brazil,2020,2520000,1110000,0,3630000,2171400,1560,242400,2415360,0,4020,0,4020,1323900,55740,1379640
BR,Brazil,2021,2982000,1212000,0,4194000,2501340,1920,237240,2740500,0,4320,0,4320,1281000,55800,1336800
BR,Brazil,2022,2184000,1302000,0,3486000,2040000,2520,237000,2279520,0,4380,0,4380,1284000,56400,1340400
BR,Brazil,2023,2490000,1368000,0,3858000,2100000,2700,240000,2342700,0,4500,0,4500,1290000,57000,1347000
BY,Burundi,2017,12000,0,0,12000,11700,0,0,11700,0,0,0,0,300,0,300
BY,Burundi,2018,12300,0,0,12300,12000,0,0,12000,0,0,0,0,300,0,300
BY,Burundi,2019,12300,0,0,12300,12000,0,0,12000,0,0,0,0,300,0,300
BY,Burundi,2020,15900,0,0,15900,15600,0,0,15600,0,0,0,0,300,0,300
BY,Burundi,2021,13800,0,0,13800,12900,0,0,12900,0,0,0,0,900,0,900
BY,Burundi,2022,12600,0,0,12600,11700,0,0,11700,0,0,0,0,900,0,900
BY,Burundi,2023,12900,0,0,12900,12000,0,0,12000,0,0,0,0,900,0,900
CA,Canada,2017,0,0,0,0,0,0,0,0,181800,13200,78000,273000,195000,78000,273000
CA,Canada,2018,0,0,0,0,0,0,0,0,182100,17100,85800,285000,199200,85800,285000
CA,Canada,2019,0,0,0,0,0,0,0,0,188100,21000,84000,293100,209100,84000,293100
CA,Canada,2020,0,0,0,0,0,0,0,0,170100,28800,90900,289800,198900,90900,289800
CA,Canada,2021,0,0,0,0,0,0,0,0,171600,28500,99600,299700,200100,99600,299700
CA,Canada,2022,0,0,0,0,0,0,0,0,171000,28500,102000,301500,199500,102000,301500
CA,Canada,2023,0,0,0,0,0,0,0,0,174000,30000,102000,306000,204000,102000,306000
CE,Sri Lanka,2017,0,0,0,0,0,0,0,0,0,0,0,0,0,0,0
CE,Sri Lanka,2018,0,0,0,0,0,0,0,0,0,0,0,0,0,0,0
CE,Sri Lanka,2019,0,0,0,0,0,0,0,0,0,0,0,0,0,0,0
CE,Sri Lanka,2020,0,0,0,0,0,0,0,0,0,0,0,0,0,0,0
CE,Sri Lanka,2021,0,0,0,0,0,0,0,0,0,0,0,0,0,0,0
CE,Sri Lanka,2022,0,0,0,0,0,0,0,0,0,0,0,0,0,0,0
CE,Sri Lanka,2023,0,0,0,0,0,0,0,0,0,0,0,0,0,0,0
CF,Congo (Brazzaville),2017,0,0,0,0,0,0,0,0,0,0,0,0,0,0,0
CF,Congo (Brazzaville),2018,0,0,0,0,0,0,0,0,0,0,0,0,0,0,0
CF,Congo (Brazzaville),2019,0,0,0,0,0,0,0,0,0,0,0,0,0,0,0
CF,Congo (Brazzaville),2020,0,0,0,0,0,0,0,0,0,0,0,0,0,0,0
CF,Congo (Brazzaville),2021,0,0,0,0,0,0,0,0,0,0,0,0,0,0,0
CF,Congo (Brazzaville),2022,0,0,0,0,0,0,0,0,0,0,0,0,0,0,0
CF,Congo (Brazzaville),2023,0,0,0,0,0,0,0,0,0,0,0,0,0,0,0
CG,Congo (Kinshasa),2017,4200,9600,0,13800,4800,0,0,4800,0,0,0,0,9000,0,9000
CG,Congo (Kinshasa),2018,4500,10500,0,15000,5700,0,0,5700,0,0,0,0,9600,0,9600
CG,Congo (Kinshasa),2019,4200,10500,0,14700,6900,0,0,6900,0,0,0,0,7800,0,7800
CG,Congo (Kinshasa),2020,4500,10800,0,15300,7500,0,0,7500,0,0,0,0,7800,0,7800
CG,Congo (Kinshasa),2021,4500,10500,0,15000,7200,0,0,7200,0,0,0,0,7800,0,7800
CG,Congo (Kinshasa),2022,4200,10800,0,15000,7500,0,0,7500,0,0,0,0,7500,0,7500
CG,Congo (Kinshasa),2023,4500,10500,0,15000,7500,0,0,7500,0,0,0,0,7500,0,7500
CH,China,2017,117000,0,0,117000,62220,6300,31800,100320,48420,23100,81000,152520,78000,84000,162000
CH,China,2018,117000,0,0,117000,83400,900,26400,110700,48900,16800,91200,156900,78000,96000,174000
CH,China,2019,115500,0,0,115500,73500,1500,21000,96000,51000,15000,91500,157500,78000,102000,180000
CH,China,2020,120000,0,0,120000,53100,900,13800,67800,54000,15600,106500,176100,102000,114000,216000
CH,China,2021,108000,0,0,108000,21600,1500,18000,41100,100500,18540,109200,228240,126000,126000,252000
CH,China,2022,120000,0,0,120000,54000,1500,24000,79500,75000,18000,108000,201000,126000,126000,252000
CH,China,2023,120000,0,0,120000,42000,1500,18000,61500,60000,18000,108000,186000,126000,126000,252000
CI,Chile,2017,0,0,0,0,0,0,0,0,12900,0,0,12900,12900,0,12900
CI,Chile,2018,0,0,0,0,0,0,0,0,14700,0,0,14700,14700,0,14700
CI,Chile,2019,0,0,0,0,0,0,0,0,14400,0,0,14400,14400,0,14400
CI,Chile,2020,0,0,0,0,0,0,0,0,14700,0,0,14700,14700,0,14700
CI,Chile,2021,0,0,0,0,0,0,0,0,12900,0,0,12900,12900,0,12900
CI,Chile,2022,0,0,0,0,0,0,0,0,12000,0,0,12000,12000,0,12000
CI,Chile,2023,0,0,0,0,0,0,0,0,12600,0,0,12600,12600,0,12600
CM,Cameroon,2017,3000,27000,0,30000,25800,0,0,25800,0,0,0,0,3600,300,3900
CM,Cameroon,2018,3000,22500,0,25500,21000,0,0,21000,0,0,0,0,4200,300,4500
CM,Cameroon,2019,3000,24000,0,27000,22500,0,0,22500,0,0,0,0,4500,300,4800
CM,Cameroon,2020,3000,25500,0,28500,24000,0,0,24000,0,0,0,0,4500,300,4800
CM,Cameroon,2021,3000,21000,0,24000,19800,0,0,19800,0,0,0,0,4500,300,4800
CM,Cameroon,2022,1500,21000,0,22500,16500,0,0,16500,0,0,0,0,5100,300,5400
CM,Cameroon,2023,3000,24000,0,27000,21000,0,0,21000,0,0,0,0,6000,0,6000
CO,Colombia,2017,876000,0,0,876000,762000,9300,54000,825300,15000,0,6600,21600,63600,23400,87000
CO,Colombia,2018,829500,0,0,829500,702000,10500,51000,763500,40200,300,6000,46500,72000,27000,99000
CO,Colombia,2019,832200,0,0,832200,744000,18900,54000,816900,58500,360,7800,66660,88500,27000,115500
CO,Colombia,2020,846000,0,0,846000,706200,12600,60000,778800,50700,300,7800,58800,78000,30000,108000
CO,Colombia,2021,804000,0,0,804000,690000,14700,59400,764100,100200,180,8700,109080,90000,36000,126000
CO,Colombia,2022,780000,0,0,780000,708000,12000,66000,786000,99000,300,9000,108300,93600,36000,129600
CO,Colombia,2023,780000,0,0,780000,708000,12000,60000,780000,102000,300,9000,111300,93000,36000,129000
CS,Costa Rica,2017,78000,0,0,78000,66600,600,0,67200,5100,600,1500,7200,21900,1500,23400
CS,Costa Rica,2018,91500,0,0,91500,72300,300,0,72600,3600,300,1620,5520,21000,1620,22620
CS,Costa Rica,2019,75000,0,0,75000,64500,300,0,64800,13200,300,300,13800,25500,300,25800
CS,Costa Rica,2020,87960,0,0,87960,67800,600,0,68400,12000,300,300,12600,27480,300,27780
CS,Costa Rica,2021,88320,0,0,88320,69300,600,0,69900,8700,600,300,9600,27900,1200,29100
CS,Costa Rica,2022,76500,0,0,76500,69600,600,0,70200,9000,300,300,9600,27000,300,27300
CS,Costa Rica,2023,81900,0,0,81900,69000,600,0,69600,9000,300,300,9600,25500,300,25800
CT,Central African Republic,2017,0,300,0,300,60,0,0,60,0,0,0,0,240,0,240
CT,Central African Republic,2018,0,180,0,180,0,0,0,0,0,0,0,0,180,0,180
CT,Central African Republic,2019,0,120,0,120,0,0,0,0,0,0,0,0,120,0,120
CT,Central African Republic,2020,0,0,0,0,0,0,0,0,0,0,0,0,0,0,0
CT,Central African Republic,2021,0,0,0,0,0,0,0,0,0,0,0,0,0,0,0
CT,Central African Republic,2022,0,0,0,0,0,0,0,0,0,0,0,0,0,0,0
CT,Central African Republic,2023,0,0,0,0,0,0,0,0,0,0,0,0,0,0,0
CU,Cuba,2017,9000,0,0,9000,900,0,0,900,0,0,0,0,8100,0,8100
CU,Cuba,2018,6000,0,0,6000,840,0,0,840,0,0,0,0,5160,0,5160
CU,Cuba,2019,6600,0,0,6600,1380,0,0,1380,0,0,0,0,5220,0,5220
CU,Cuba,2020,5400,0,0,5400,600,0,0,600,0,0,0,0,4800,0,4800
CU,Cuba,2021,6000,0,0,6000,900,0,0,900,0,0,0,0,5100,0,5100
CU,Cuba,2022,6000,0,0,6000,1200,0,0,1200,0,0,0,0,4800,0,4800
CU,Cuba,2023,6000,0,0,6000,1200,0,0,1200,0,0,0,0,4800,0,4800
DM,Benin,2017,0,0,0,0,0,0,0,0,0,0,0,0,0,0,0
DM,Benin,2018,0,0,0,0,0,0,0,0,0,0,0,0,0,0,0
DM,Benin,2019,0,0,0,0,0,0,0,0,0,0,0,0,0,0,0
DM,Benin,2020,0,0,0,0,0,0,0,0,0,0,0,0,0,0,0
DM,Benin,2021,0,0,0,0,0,0,0,0,0,0,0,0,0,0,0
DM,Benin,2022,0,0,0,0,0,0,0,0,0,0,0,0,0,0,0
DM,Benin,2023,0,0,0,0,0,0,0,0,0,0,0,0,0,0,0
DR,Dominican Republic,2017,13500,0,0,13500,780,0,0,780,0,0,0,0,12720,0,12720
DR,Dominican Republic,2018,7500,0,0,7500,780,0,0,780,0,0,0,0,6720,0,6720
DR,Dominican Republic,2019,7500,0,0,7500,720,0,0,720,0,0,0,0,6780,0,6780
DR,Dominican Republic,2020,7200,0,0,7200,600,0,0,600,0,0,0,0,6600,0,6600
DR,Dominican Republic,2021,7200,0,0,7200,600,0,0,600,0,0,0,0,6600,0,6600
DR,Dominican Republic,2022,7500,0,0,7500,720,0,0,720,0,0,0,0,6780,0,6780
DR,Dominican Republic,2023,7500,0,0,7500,900,0,0,900,0,0,0,0,6600,0,6600
E4,European Union,2017,0,0,0,0,0,109200,45600,154800,2605500,0,0,2605500,2193300,149400,2342700
E4,European Union,2018,0,0,0,0,0,112500,58200,170700,2670600,0,0,2670600,2390700,133200,2523900
E4,European Union,2019,0,0,0,0,0,108360,69600,177960,2753400,0,0,2753400,2399520,126000,2525520
E4,European Union,2020,0,0,0,0,0,136500,72900,209400,2667600,0,0,2667600,2277840,138000,2415840
E4,European Union,2021,0,0,0,0,0,141900,88500,230400,2632500,0,0,2632500,2337960,140400,2478360
E4,European Union,2022,0,0,0,0,0,126000,102000,228000,2700000,0,0,2700000,2400000,132000,2532000
E4,European Union,2023,0,0,0,0,0,120000,90000,210000,2760000,0,0,2760000,2430000,144000,2574000
EC,Ecuador,2017,4200,6000,0,10200,5340,60,29040,34440,34500,180,4200,38880,2220,10800,13020
EC,Ecuador,2018,5700,6600,0,12300,7920,60,34320,42300,37500,180,4800,42480,2340,11580,13920
EC,Ecuador,2019,8400,6900,0,15300,4500,60,24600,29160,22200,60,5100,27360,2580,11820,14400
EC,Ecuador,2020,9300,7200,0,16500,5100,60,22200,27360,21000,60,5400,26460,2880,12000,14880
EC,Ecuador,2021,5280,10020,0,15300,1440,60,28500,30000,21000,60,5400,26460,2400,12000,14400
EC,Ecuador,2022,5400,10200,0,15600,1800,60,24780,26640,19800,60,5400,25260,2700,12000,14700
EC,Ecuador,2023,6780,14460,0,21240,3600,120,27900,31620,19800,60,6600,26460,2700,16980,19680
EG,Egypt,2017,0,0,0,0,0,0,0,0,37800,0,0,37800,37800,0,37800
EG,Egypt,2018,0,0,0,0,0,0,0,0,48000,0,0,48000,48000,0,48000
EG,Egypt,2019,0,0,0,0,0,0,0,0,49500,0,0,49500,49500,0,49500
EG,Egypt,2020,0,0,0,0,0,0,0,0,45000,0,0,45000,45000,0,45000
EG,Egypt,2021,0,0,0,0,0,0,0,0,24000,0,0,24000,24000,0,24000
EG,Egypt,2022,0,0,0,0,0,0,0,0,24000,0,0,24000,24000,0,24000
EG,Egypt,2023,0,0,0,0,0,0,0,0,30000,0,0,30000,30000,0,30000
EK,Equatorial Guinea,2017,0,0,0,0,0,0,0,0,0,0,0,0,0,0,0
EK,Equatorial Guinea,2018,0,0,0,0,0,0,0,0,0,0,0,0,0,0,0
EK,Equatorial Guinea,2019,0,0,0,0,0,0,0,0,0,0,0,0,0,0,0
EK,Equatorial Guinea,2020,0,0,0,0,0,0,0,0,0,0,0,0,0,0,0
EK,Equatorial Guinea,2021,0,0,0,0,0,0,0,0,0,0,0,0,0,0,0
EK,Equatorial Guinea,2022,0,0,0,0,0,0,0,0,0,0,0,0,0,0,0
EK,Equatorial Guinea,2023,0,0,0,0,0,0,0,0,0,0,0,0,0,0,0
ES,El Salvador,2017,36000,0,0,36000,31200,0,0,31200,0,600,11400,12000,4500,11400,15900
ES,El Salvador,2018,39600,0,0,39600,35400,0,0,35400,0,600,12300,12900,4500,12600,17100
ES,El Salvador,2019,39240,0,0,39240,36060,0,840,36900,120,660,12780,13560,2100,13020,15120
ES,El Salvador,2020,30600,0,0,30600,32580,0,720,33300,720,780,15480,16980,1800,14400,16200
ES,El Salvador,2021,32400,0,0,32400,31620,0,900,32520,840,900,12900,14640,1800,12000,13800
ES,El Salvador,2022,35400,0,0,35400,35100,0,660,35760,840,900,12000,13740,1800,12000,13800
ES,El Salvador,2023,34500,0,0,34500,33000,0,600,33600,900,900,12000,13800,1800,12900,14700
ET,Ethiopia,2017,416580,0,0,416580,231180,0,0,231180,0,0,0,0,186000,0,186000
ET,Ethiopia,2018,423300,0,0,423300,233580,0,0,233580,0,0,0,0,189000,0,189000
ET,Ethiopia,2019,441000,0,0,441000,250440,0,0,250440,0,0,0,0,191580,0,191580
ET,Ethiopia,2020,448500,0,0,448500,248100,0,0,248100,0,0,0,0,188400,0,188400
ET,Ethiopia,2021,456000,0,0,456000,280500,0,0,280500,0,0,0,0,180000,0,180000
ET,Ethiopia,2022,489000,0,0,489000,282000,0,0,282000,0,0,0,0,208500,0,208500
ET,Ethiopia,2023,495000,0,0,495000,283500,0,0,283500,0,0,0,0,210000,0,210000
GB,Gabon,2017,0,0,0,0,0,0,0,0,0,0,0,0,0,0,0
GB,Gabon,2018,0,0,0,0,0,0,0,0,0,0,0,0,0,0,0
GB,Gabon,2019,0,0,0,0,0,0,0,0,0,0,0,0,0,0,0
GB,Gabon,2020,0,0,0,0,0,0,0,0,0,0,0,0,0,0,0
GB,Gabon,2021,0,0,0,0,0,0,0,0,0,0,0,0,0,0,0
GB,Gabon,2022,0,0,0,0,0,0,0,0,0,0,0,0,0,0,0
GB,Gabon,2023,0,0,0,0,0,0,0,0,0,0,0,0,0,0,0
GH,Ghana,2017,0,60,0,60,0,0,0,0,0,0,0,0,180,0,180
GH,Ghana,2018,0,60,0,60,0,0,0,0,0,0,0,0,180,0,180
GH,Ghana,2019,0,0,0,0,0,0,0,0,0,0,0,0,0,0,0
GH,Ghana,2020,0,0,0,0,0,0,0,0,0,0,0,0,0,0,0
GH,Ghana,2021,0,0,0,0,0,0,0,0,0,0,0,0,0,0,0
GH,Ghana,2022,0,0,0,0,0,0,0,0,0,0,0,0,0,0,0
GH,Ghana,2023,0,0,0,0,0,0,0,0,0,0,0,0,0,0,0
GT,Guatemala,2017,204000,10200,0,214200,199500,0,300,199800,0,0,13500,13500,13500,13800,27300
GT,Guatemala,2018,216000,10800,0,226800,207600,0,300,207900,0,0,14400,14400,14700,14400,29100
GT,Guatemala,2019,211200,15000,0,226200,216000,0,240,216240,0,240,14700,14940,15000,14700,29700
GT,Guatemala,2020,210900,7800,0,218700,192660,240,300,193200,0,240,18000,18240,20100,18000,38100
GT,Guatemala,2021,228600,7200,0,235800,220500,300,660,221460,0,420,21000,21420,15300,21000,36300
GT,Guatemala,2022,222000,7800,0,229800,210000,240,600,210840,0,240,14700,14940,20460,14700,35160
GT,Guatemala,2023,216000,7800,0,223800,204000,300,600,204900,0,300,15000,15300,18000,18000,36000
GU,Guinea,2017,0,12000,0,12000,10800,0,0,10800,0,0,0,0,1140,0,1140
GU,Guinea,2018,0,11400,0,11400,9600,0,0,9600,0,0,0,0,1200,0,1200
GU,Guinea,2019,0,4200,0,4200,4200,0,0,4200,0,0,0,0,900,0,900
GU,Guinea,2020,0,8700,0,8700,7500,0,0,7500,0,0,0,0,1200,0,1200
GU,Guinea,2021,0,4200,0,4200,3600,0,0,3600,0,0,0,0,600,0,600
GU,Guinea,2022,0,6900,0,6900,6000,0,0,6000,0,0,0,0,900,0,900
GU,Guinea,2023,0,6900,0,6900,6000,0,0,6000,0,0,0,0,900,0,900
GY,Guyana,2017,0,0,0,0,0,0,0,0,0,0,0,0,0,0,0
GY,Guyana,2018,0,0,0,0,0,0,0,0,0,0,0,0,0,0,0
GY,Guyana,2019,0,0,0,0,0,0,0,0,0,0,0,0,0,0,0
GY,Guyana,2020,0,0,0,0,0,0,0,0,0,0,0,0,0,0,0
GY,Guyana,2021,0,0,0,0,0,0,0,0,0,0,0,0,0,0,0
GY,Guyana,2022,0,0,0,0,0,0,0,0,0,0,0,0,0,0,0
GY,Guyana,2023,0,0,0,0,0,0,0,0,0,0,0,0,0,0,0
HA,Haiti,2017,0,0,0,0,0,0,0,0,0,0,0,0,0,0,0
HA,Haiti,2018,0,0,0,0,0,0,0,0,0,0,0,0,0,0,0
HA,Haiti,2019,0,0,0,0,0,0,0,0,0,0,0,0,0,0,0
HA,Haiti,2020,0,0,0,0,0,0,0,0,0,0,0,0,0,0,0
HA,Haiti,2021,0,0,0,0,0,0,0,0,0,0,0,0,0,0,0
HA,Haiti,2022,0,0,0,0,0,0,0,0,0,0,0,0,0,0,0
HA,Haiti,2023,0,0,0,0,0,0,0,0,0,0,0,0,0,0,0
HO,Honduras,2017,450600,0,0,450600,430500,0,0,430500,0,0,1500,1500,21000,1500,22500
HO,Honduras,2018,456000,0,0,456000,433500,0,0,433500,0,0,1500,1500,21000,1500,22500
HO,Honduras,2019,426000,0,0,426000,414600,0,0,414600,0,0,720,720,20760,1140,21900
HO,Honduras,2020,312000,0,0,312000,294000,0,0,294000,0,0,1680,1680,20760,1200,21960
HO,Honduras,2021,390000,0,0,390000,360600,0,0,360600,0,0,1440,1440,20880,1260,22140
HO,Honduras,2022,324000,0,0,324000,312000,0,0,312000,0,0,1260,1260,21060,1320,22380
HO,Honduras,2023,360000,0,0,360000,336000,0,0,336000,0,0,1320,1320,21300,1320,22620
HR,Croatia,2017,0,0,0,0,0,0,0,0,0,0,0,0,0,0,0
HR,Croatia,2018,0,0,0,0,0,0,0,0,0,0,0,0,0,0,0
HR,Croatia,2019,0,0,0,0,0,0,0,0,0,0,0,0,0,0,0
HR,Croatia,2020,0,0,0,0,0,0,0,0,0,0,0,0,0,0,0
HR,Croatia,2021,0,0,0,0,0,0,0,0,0,0,0,0,0,0,0
HR,Croatia,2022,0,0,0,0,0,0,0,0,0,0,0,0,0,0,0
HR,Croatia,2023,0,0,0,0,0,0,0,0,0,0,0,0,0,0,0
ID,Indonesia,2017,78000,558000,0,636000,438540,3900,48000,490440,20520,600,23460,44580,143580,48600,192180
ID,Indonesia,2018,60000,564000,0,624000,416400,4200,60000,480600,52500,2880,49680,105060,159000,54600,213600
ID,Indonesia,2019,72000,564000,0,636000,294420,2580,72000,369000,40440,1140,58980,100560,186000,72000,258000
ID,Indonesia,2020,75000,567000,0,642000,365760,3360,60000,429120,26700,1200,45960,73860,204000,90000,294000
ID,Indonesia,2021,78000,564000,0,642000,387960,3360,81000,472320,13800,720,45060,59580,180000,87000,267000
ID,Indonesia,2022,76800,558000,0,634800,378000,3000,63000,444000,13500,600,40500,54600,195000,90000,285000
ID,Indonesia,2023,81000,600000,0,681000,390000,3000,66000,459000,18000,900,48000,66900,196800,91200,288000
IN,India,2017,94980,217020,0,312000,256380,300,112800,369480,78360,120,4680,83160,33000,39000,72000
IN,India,2018,94980,220980,0,315960,247620,240,121020,368880,83100,120,5100,88320,31500,41400,72900
IN,India,2019,94980,224520,0,319500,236160,240,110280,346680,78120,120,4920,83160,31800,43200,75000
IN,India,2020,87000,211020,0,298020,203940,240,106920,311100,81240,120,4440,85800,30000,40200,70200
IN,India,2021,79200,235020,0,314220,229080,360,118200,347640,75360,60,5280,80700,25020,45780,70800
IN,India,2022,76800,255000,0,331800,229800,300,120000,350100,78420,120,4800,83340,25800,46800,72600
IN,India,2023,79200,265200,0,344400,235200,300,123000,358500,82200,900,5700,88800,26100,48000,74100
IR,Iran,2017,0,0,0,0,0,0,0,0,6300,0,18000,24300,6300,18000,24300
IR,Iran,2018,0,0,0,0,0,0,0,0,9000,0,33600,42600,9000,33600,42600
IR,Iran,2019,0,0,0,0,0,0,0,0,12900,0,18000,30900,12900,18000,30900
IR,Iran,2020,0,0,0,0,0,0,0,0,12300,0,18000,30300,12300,18000,30300
IR,Iran,2021,0,0,0,0,0,0,0,0,23100,0,18000,41100,23100,18000,41100
IR,Iran,2022,0,0,0,0,0,0,0,0,27000,0,16500,43500,27000,16500,43500
IR,Iran,2023,0,0,0,0,0,0,0,0,30000,0,16500,46500,28500,18000,46500
IV,Cote d'Ivoire,2017,0,65400,0,65400,46800,0,12600,59400,0,0,0,0,6000,0,6000
IV,Cote d'Ivoire,2018,0,75000,0,75000,57000,0,12000,69000,0,0,0,0,6000,0,6000
IV,Cote d'Ivoire,2019,0,120000,0,120000,103500,0,12900,116400,0,0,0,0,3600,0,3600
IV,Cote d'Ivoire,2020,0,103500,0,103500,85500,0,14400,99900,0,0,0,0,3900,0,3900
IV,Cote d'Ivoire,2021,0,54600,0,54600,34800,0,17100,51900,0,0,0,0,3000,0,3000
IV,Cote d'Ivoire,2022,0,48000,0,48000,33000,0,12000,45000,0,0,0,0,3000,0,3000
IV,Cote d'Ivoire,2023,0,48000,0,48000,33000,0,12000,45000,0,0,0,0,3000,0,3000
JA,Japan,2017,0,0,0,0,0,0,0,0,420000,6300,55500,481800,437100,55500,492600
JA,Japan,2018,0,0,0,0,0,0,0,0,390000,4800,68400,463200,425460,68400,493860
JA,Japan,2019,0,0,0,0,0,0,0,0,442200,5400,51600,499200,422220,51600,473820
JA,Japan,2020,0,0,0,0,0,0,0,0,393000,6600,37800,437400,418800,37800,456600
JA,Japan,2021,0,0,0,0,0,0,0,0,391200,6000,31800,429000,409440,31800,441240
JA,Japan,2022,0,0,0,0,0,0,0,0,408000,5400,36000,449400,429000,36000,465000
JA,Japan,2023,0,0,0,0,0,0,0,0,414000,6000,42000,462000,433980,42000,475980
JM,Jamaica,2017,960,0,0,960,660,0,0,660,0,0,0,0,300,0,300
JM,Jamaica,2018,960,0,0,960,660,0,0,660,0,0,0,0,300,0,300
JM,Jamaica,2019,900,0,0,900,600,0,0,600,0,0,0,0,300,0,300
JM,Jamaica,2020,960,0,0,960,660,0,0,660,0,0,0,0,300,0,300
JM,Jamaica,2021,900,0,0,900,660,0,0,660,0,0,0,0,240,0,240
JM,Jamaica,2022,900,0,0,900,660,0,0,660,0,0,0,0,240,0,240
JM,Jamaica,2023,900,0,0,900,600,0,0,600,0,0,0,0,300,0,300
JO,Jordan,2017,0,0,0,0,0,0,0,0,21600,0,15900,37500,21600,15900,37500
JO,Jordan,2018,0,0,0,0,0,0,0,0,28200,0,18300,46500,28200,18300,46500
JO,Jordan,2019,0,0,0,0,0,0,0,0,31200,0,18900,50100,31200,18900,50100
JO,Jordan,2020,0,0,0,0,0,0,0,0,27600,0,18600,46200,27600,18600,46200
JO,Jordan,2021,0,0,0,0,0,0,0,0,31800,0,18900,50700,31800,18900,50700
JO,Jordan,2022,0,0,0,0,0,0,0,0,25200,0,19500,44700,25200,19500,44700
JO,Jordan,2023,0,0,0,0,0,0,0,0,30000,0,21000,51000,30000,21000,51000
KE,Kenya,2017,51000,0,0,51000,45900,0,0,45900,0,0,660,660,2100,660,2760
KE,Kenya,2018,43200,0,0,43200,41700,0,0,41700,0,0,540,540,2100,540,2640
KE,Kenya,2019,51000,0,0,51000,49620,0,0,49620,0,0,900,900,2400,900,3300
KE,Kenya,2020,45000,0,0,45000,44220,0,0,44220,0,0,660,660,1500,660,2160
KE,Kenya,2021,39000,0,0,39000,39300,0,0,39300,0,0,660,660,3660,1200,4860
KE,Kenya,2022,45000,0,0,45000,39000,0,0,39000,0,0,780,780,3600,780,4380
KE,Kenya,2023,42000,0,0,42000,40500,0,0,40500,0,0,900,900,3000,1200,4200
KS,"Korea, South",2017,0,0,0,0,0,0,0,0,150000,13500,0,163500,163500,0,163500
KS,"Korea, South",2018,0,0,0,0,0,0,0,0,144000,14700,0,158700,158700,0,158700
KS,"Korea, South",2019,0,0,0,0,0,0,0,0,148800,17400,0,166200,166200,0,166200
KS,"Korea, South",2020,0,0,0,0,0,0,0,0,159600,19200,0,178800,178800,0,178800
KS,"Korea, South",2021,0,0,0,0,0,0,0,0,158100,21600,0,179700,179700,0,179700
KS,"Korea, South",2022,0,0,0,0,0,0,0,0,162000,21000,0,183000,183000,0,183000
KS,"Korea, South",2023,0,0,0,0,0,0,0,0,165000,21000,0,186000,186000,0,186000
KZ,Kazakhstan,2017,0,0,0,0,0,0,0,0,0,0,6000,6000,0,6000,6000
KZ,Kazakhstan,2018,0,0,0,0,0,0,0,0,0,0,10800,10800,0,10800,10800
KZ,Kazakhstan,2019,0,0,0,0,0,0,0,0,0,0,9000,9000,0,9000,9000
KZ,Kazakhstan,2020,0,0,0,0,0,0,0,0,0,0,13500,13500,0,13500,13500
KZ,Kazakhstan,2021,0,0,0,0,0,0,0,0,0,0,12600,12600,0,12600,12600
KZ,Kazakhstan,2022,0,0,0,0,0,0,0,0,0,0,16200,16200,0,16200,16200
KZ,Kazakhstan,2023,0,0,0,0,0,0,0,0,0,0,18000,18000,0,18000,18000
LA,Laos,2017,0,24600,0,24600,18600,0,0,18600,0,0,0,0,6000,0,6000
LA,Laos,2018,0,27000,0,27000,21000,0,0,21000,0,0,0,0,6000,0,6000
LA,Laos,2019,0,22500,0,22500,16800,0,0,16800,0,0,0,0,5700,0,5700
LA,Laos,2020,0,26400,0,26400,20400,0,0,20400,0,0,0,0,6000,0,6000
LA,Laos,2021,0,29100,0,29100,24000,0,0,24000,0,0,0,0,5100,0,5100
LA,Laos,2022,0,27900,0,27900,22800,0,0,22800,0,0,0,0,5100,0,5100
LA,Laos,2023,0,29100,0,29100,24000,0,0,24000,0,0,0,0,5100,0,5100
LI,Liberia,2017,0,0,0,0,0,0,0,0,0,0,0,0,0,0,0
LI,Liberia,2018,0,0,0,0,0,0,0,0,0,0,0,0,0,0,0
LI,Liberia,2019,0,0,0,0,0,0,0,0,0,0,0,0,0,0,0
LI,Liberia,2020,0,0,0,0,0,0,0,0,0,0,0,0,0,0,0
LI,Liberia,2021,0,0,0,0,0,0,0,0,0,0,0,0,0,0,0
LI,Liberia,2022,0,0,0,0,0,0,0,0,0,0,0,0,0,0,0
LI,Liberia,2023,0,0,0,0,0,0,0,0,0,0,0,0,0,0,0
MA,Madagascar,2017,1500,16200,0,17700,4800,0,0,4800,0,0,0,0,12900,0,12900
MA,Madagascar,2018,1500,13500,0,15000,1500,0,0,1500,0,0,0,0,13500,0,13500
MA,Madagascar,2019,1800,15000,0,16800,300,0,0,300,0,0,0,0,16500,0,16500
MA,Madagascar,2020,1500,18000,0,19500,1500,0,0,1500,0,0,0,0,18000,0,18000
MA,Madagascar,2021,1500,18000,0,19500,2100,0,0,2100,0,0,0,0,17400,0,17400
MA,Madagascar,2022,1500,16500,0,18000,900,0,0,900,0,0,0,0,17100,0,17100
MA,Madagascar,2023,1500,18000,0,19500,1500,0,0,1500,0,0,0,0,18000,0,18000
MI,Malawi,2017,960,0,0,960,900,0,0,900,0,0,0,0,60,0,60
MI,Malawi,2018,720,0,0,720,660,0,0,660,0,0,0,0,60,0,60
MI,Malawi,2019,660,0,0,660,600,0,0,600,0,0,0,0,60,0,60
MI,Malawi,2020,600,0,0,600,540,0,0,540,0,0,0,0,60,0,60
MI,Malawi,2021,600,0,0,600,540,0,0,540,0,0,0,0,60,0,60
MI,Malawi,2022,660,0,0,660,600,0,0,600,0,0,0,0,60,0,60
MI,Malawi,2023,660,0,0,660,600,0,0,600,0,0,0,0,60,0,60
MO,Morocco,2017,0,0,0,0,0,0,0,0,38400,1200,0,39600,39600,0,39600
MO,Morocco,2018,0,0,0,0,0,0,0,0,48000,1500,0,49500,49500,0,49500
MO,Morocco,2019,0,0,0,0,0,0,0,0,49500,1200,0,50700,50700,0,50700
MO,Morocco,2020,0,0,0,0,0,0,0,0,40500,2100,0,42600,42600,0,42600
MO,Morocco,2021,0,0,0,0,0,0,0,0,48900,3900,0,52800,52800,0,52800
MO,Morocco,2022,0,0,0,0,0,0,0,0,52500,2400,0,54900,54900,0,54900
MO,Morocco,2023,0,0,0,0,0,0,0,0,54000,3000,0,57000,57000,0,57000
MX,Mexico,2017,186000,12000,0,198000,104400,9300,58200,171900,75900,4800,13200,93900,48600,74820,123420
MX,Mexico,2018,228000,12000,0,240000,122400,10800,60000,193200,74100,5100,13500,92700,49200,88500,137700
MX,Mexico,2019,186000,27000,0,213000,103860,13320,56580,173760,86100,5040,14940,106080,58200,96600,154800
MX,Mexico,2020,189000,33000,0,222000,110100,12360,56700,179160,91320,4680,22800,118800,57000,100200,157200
MX,Mexico,2021,185700,31800,0,217500,118440,15120,51900,185460,94920,6060,18060,119040,57000,99000,156000
MX,Mexico,2022,198000,32400,0,230400,114000,13800,63000,190800,96000,7800,18000,121800,60000,99000,159000
MX,Mexico,2023,198000,32700,0,230700,114000,13800,66000,193800,96000,9000,18000,123000,60000,102000,162000
MY,Malaysia,2017,0,126000,0,126000,0,0,176400,176400,90600,0,0,90600,0,40200,40200
MY,Malaysia,2018,0,126000,0,126000,0,0,184500,184500,94500,0,0,94500,0,36000,36000
MY,Malaysia,2019,0,126000,0,126000,0,0,187500,187500,112500,0,0,112500,0,51000,51000
MY,Malaysia,2020,0,114000,0,114000,0,0,180000,180000,104100,0,0,104100,0,38100,38100
MY,Malaysia,2021,0,120000,0,120000,0,0,166800,166800,94800,0,0,94800,0,48000,48000
MY,Malaysia,2022,0,120000,0,120000,0,0,174000,174000,99000,0,0,99000,0,45000,45000
MY,Malaysia,2023,0,120000,0,120000,0,0,180000,180000,102000,0,0,102000,0,42000,42000
NC,New Caledonia,2017,0,0,0,0,0,0,0,0,0,0,0,0,0,0,0
NC,New Caledonia,2018,0,0,0,0,0,0,0,0,0,0,0,0,0,0,0
NC,New Caledonia,2019,0,0,0,0,0,0,0,0,0,0,0,0,0,0,0
NC,New Caledonia,2020,0,0,0,0,0,0,0,0,0,0,0,0,0,0,0
NC,New Caledonia,2021,0,0,0,0,0,0,0,0,0,0,0,0,0,0,0
NC,New Caledonia,2022,0,0,0,0,0,0,0,0,0,0,0,0,0,0,0
NC,New Caledonia,2023,0,0,0,0,0,0,0,0,0,0,0,0,0,0,0
NI,Nigeria,2017,0,600,0,600,120,0,0,120,0,0,0,0,480,0,480
NI,Nigeria,2018,0,300,0,300,120,0,0,120,0,0,0,0,180,0,180
NI,Nigeria,2019,0,0,0,0,0,0,0,0,0,0,0,0,0,0,0
NI,Nigeria,2020,0,0,0,0,0,0,0,0,0,0,0,0,0,0,0
NI,Nigeria,2021,0,0,0,0,0,0,0,0,0,0,0,0,0,0,0
NI,Nigeria,2022,0,0,0,0,0,0,0,0,0,0,0,0,0,0,0
NI,Nigeria,2023,0,0,0,0,0,0,0,0,0,0,0,0,0,0,0
NO,Norway,2017,0,0,0,0,0,0,0,0,36000,7500,4800,48300,43500,4800,48300
NO,Norway,2018,0,0,0,0,0,0,0,0,30900,8400,5100,44400,39300,5100,44400
NO,Norway,2019,0,0,0,0,0,0,0,0,34500,8100,5400,48000,42600,5400,48000
NO,Norway,2020,0,0,0,0,0,0,0,0,34800,7200,5700,47700,42000,5700,47700
NO,Norway,2021,0,0,0,0,0,0,0,0,34800,8100,6000,48900,42900,6000,48900
NO,Norway,2022,0,0,0,0,0,0,0,0,31500,6600,5400,43500,38100,5400,43500
NO,Norway,2023,0,0,0,0,0,0,0,0,33000,6000,6000,45000,39000,6000,45000
NU,Nicaragua,2017,156000,1500,0,157500,140400,600,6000,147000,600,0,1800,2400,5400,5400,10800
NU,Nicaragua,2018,162000,1800,0,163800,144600,300,6000,150900,300,0,1500,1800,5700,4800,10500
NU,Nicaragua,2019,174000,3000,0,177000,160500,300,6600,167400,300,0,1500,1800,5400,5700,11100
NU,Nicaragua,2020,160500,4800,0,165300,156300,600,7200,164100,300,0,1500,1800,4500,4800,9300
NU,Nicaragua,2021,149100,7200,0,156300,141900,600,6600,149100,300,0,1500,1800,4800,4800,9600
NU,Nicaragua,2022,160800,7200,0,168000,152400,600,6000,159000,300,0,1500,1800,4800,4800,9600
NU,Nicaragua,2023,160800,7200,0,168000,151200,600,6000,157800,300,0,1500,1800,4800,4800,9600
NZ,New Zealand,2017,0,0,0,0,0,0,0,0,12600,1200,10500,24300,13800,10500,24300
NZ,New Zealand,2018,0,0,0,0,0,0,0,0,13200,1500,10800,25500,14700,10800,25500
NZ,New Zealand,2019,0,0,0,0,0,0,0,0,13200,1500,11400,26100,14700,11400,26100
NZ,New Zealand,2020,0,0,0,0,0,0,0,0,12600,2100,12300,27000,14700,12300,27000
NZ,New Zealand,2021,0,0,0,0,0,0,0,0,13200,2100,16200,31500,16800,14700,31500
NZ,New Zealand,2022,0,0,0,0,0,0,0,0,12000,1500,16500,30000,13500,16500,30000
NZ,New Zealand,2023,0,0,0,0,0,0,0,0,13500,1500,18000,33000,15000,18000,33000
PA,Paraguay,2017,0,0,0,0,0,0,0,0,0,0,0,0,0,0,0
PA,Paraguay,2018,0,0,0,0,0,0,0,0,0,0,0,0,0,0,0
PA,Paraguay,2019,0,0,0,0,0,0,0,0,0,0,0,0,0,0,0
PA,Paraguay,2020,0,0,0,0,0,0,0,0,0,0,0,0,0,0,0
PA,Paraguay,2021,0,0,0,0,0,0,0,0,0,0,0,0,0,0,0
PA,Paraguay,2022,0,0,0,0,0,0,0,0,0,0,0,0,0,0,0
PA,Paraguay,2023,0,0,0,0,0,0,0,0,0,0,0,0,0,0,0
PE,Peru,2017,253500,0,0,253500,241500,0,0,241500,0,0,0,0,540,9600,10140
PE,Peru,2018,262500,0,0,262500,251100,0,0,251100,0,0,0,0,600,10200,10800
PE,Peru,2019,263400,0,0,263400,257580,0,0,257580,0,0,0,0,600,9600,10200
PE,Peru,2020,235500,0,0,235500,223200,0,0,223200,0,0,7140,7140,900,11700,12600
PE,Peru,2021,202140,0,0,202140,199560,0,0,199560,0,0,8280,8280,1140,12180,13320
PE,Peru,2022,252000,0,0,252000,246000,0,0,246000,0,0,7200,7200,1500,12000,13500
PE,Peru,2023,252000,0,0,252000,246000,0,0,246000,0,0,7200,7200,1500,12000,13500
PN,Panama,2017,5700,0,0,5700,1620,1800,0,3420,1800,0,900,2700,4080,900,4980
PN,Panama,2018,4500,0,0,4500,360,1800,0,2160,1680,0,900,2580,3120,1800,4920
PN,Panama,2019,4500,0,0,4500,180,2400,0,2580,1680,0,1200,2880,3600,1200,4800
PN,Panama,2020,4500,0,0,4500,480,2400,0,2880,1800,0,600,2400,3120,900,4020
PN,Panama,2021,4500,0,0,4500,180,1800,0,1980,1800,0,900,2700,4200,1020,5220
PN,Panama,2022,4500,0,0,4500,300,1800,0,2100,1500,0,1200,2700,4200,900,5100
PN,Panama,2023,5400,0,0,5400,300,1800,0,2100,1500,0,900,2400,4500,1200,5700
PP,Papua New Guinea,2017,63900,3000,0,66900,63900,0,0,63900,0,0,0,0,3000,0,3000
PP,Papua New Guinea,2018,45600,3000,0,48600,45600,0,0,45600,0,0,0,0,3000,0,3000
PP,Papua New Guinea,2019,54900,3000,0,57900,54900,0,0,54900,0,0,0,0,3000,0,3000
PP,Papua New Guinea,2020,46500,3000,0,49500,46500,0,0,46500,0,0,0,0,3060,0,3060
PP,Papua New Guinea,2021,39000,3000,0,42000,39000,0,0,39000,0,0,0,0,3000,0,3000
PP,Papua New Guinea,2022,42000,3000,0,45000,42000,0,0,42000,0,0,0,0,3000,0,3000
PP,Papua New Guinea,2023,45000,3000,0,48000,45000,0,0,45000,0,0,0,0,3000,0,3000
RB,Serbia,2017,0,0,0,0,0,0,0,0,30000,0,7500,37500,30000,7500,37500
RB,Serbia,2018,0,0,0,0,0,0,0,0,28500,0,15000,43500,28500,15000,43500
RB,Serbia,2019,0,0,0,0,0,0,0,0,30000,0,18000,48000,30000,18000,48000
RB,Serbia,2020,0,0,0,0,0,0,0,0,29400,0,18900,48300,29400,18900,48300
RB,Serbia,2021,0,0,0,0,0,0,0,0,30000,0,20100,50100,30000,20100,50100
RB,Serbia,2022,0,0,0,0,0,0,0,0,30000,0,19200,49200,30000,19200,49200
RB,Serbia,2023,0,0,0,0,0,0,0,0,31500,0,19500,51000,30900,20100,51000
RH,Zimbabwe,2017,0,0,0,0,0,0,0,0,0,0,0,0,0,0,0
RH,Zimbabwe,2018,0,0,0,0,0,0,0,0,0,0,0,0,0,0,0
RH,Zimbabwe,2019,0,0,0,0,0,0,0,0,0,0,0,0,0,0,0
RH,Zimbabwe,2020,0,0,0,0,0,0,0,0,0,0,0,0,0,0,0
RH,Zimbabwe,2021,0,0,0,0,0,0,0,0,0,0,0,0,0,0,0
RH,Zimbabwe,2022,0,0,0,0,0,0,0,0,0,0,0,0,0,0,0
RH,Zimbabwe,2023,0,0,0,0,0,0,0,0,0,0,0,0,0,0,0
RP,Philippines,2017,1500,27000,0,28500,0,0,0,0,25200,0,360000,385200,15000,404700,419700
RP,Philippines,2018,1500,25500,0,27000,0,0,0,0,36000,0,330000,366000,26400,366600,393000
RP,Philippines,2019,1500,24000,0,25500,0,0,0,0,36000,0,330000,366000,24000,343500,367500
RP,Philippines,2020,1500,25500,0,27000,0,0,0,0,40200,0,300000,340200,24000,343200,367200
RP,Philippines,2021,1500,24000,0,25500,0,0,0,0,40800,0,330000,370800,24000,372300,396300
RP,Philippines,2022,1500,25500,0,27000,0,0,0,0,40500,0,342000,382500,27000,394500,421500
RP,Philippines,2023,1500,27000,0,28500,0,0,0,0,42000,0,330000,372000,30000,376500,406500
RS,Russia,2017,0,0,0,0,0,0,0,0,162600,19500,102300,284400,182100,102300,284400
RS,Russia,2018,0,0,0,0,0,0,0,0,171600,23400,72900,267900,195000,72900,267900
RS,Russia,2019,0,0,0,0,0,0,0,0,184200,28500,84000,296700,212700,84000,296700
RS,Russia,2020,0,0,0,0,0,0,0,0,190800,25800,60900,277500,216600,60900,277500
RS,Russia,2021,0,0,0,0,0,0,0,0,203400,27600,18900,249900,231000,18900,249900
RS,Russia,2022,0,0,0,0,0,0,0,0,198000,24000,21000,243000,222000,21000,243000
RS,Russia,2023,0,0,0,0,0,0,0,0,168000,21000,24000,213000,189000,24000,213000
RW,Rwanda,2017,13800,0,0,13800,13800,0,0,13800,0,0,0,0,0,0,0
RW,Rwanda,2018,16500,0,0,16500,16500,0,0,16500,0,0,0,0,0,0,0
RW,Rwanda,2019,16500,0,0,16500,16500,0,0,16500,0,0,0,0,0,0,0
RW,Rwanda,2020,21000,0,0,21000,21000,0,0,21000,0,0,0,0,0,0,0
RW,Rwanda,2021,18000,0,0,18000,18000,0,0,18000,0,0,0,0,0,0,0
RW,Rwanda,2022,21000,0,0,21000,21000,0,0,21000,0,0,0,0,0,0,0
RW,Rwanda,2023,19500,0,0,19500,19500,0,0,19500,0,0,0,0,0,0,0
SA,Saudi Arabia,2017,0,0,0,0,0,0,0,0,47400,3000,0,50400,50400,0,50400
SA,Saudi Arabia,2018,0,0,0,0,0,0,0,0,51600,4500,0,56100,56100,0,56100
SA,Saudi Arabia,2019,0,0,0,0,0,0,0,0,49800,9000,0,58800,58800,0,58800
SA,Saudi Arabia,2020,0,0,0,0,0,0,0,0,51000,11400,0,62400,62400,0,62400
SA,Saudi Arabia,2021,0,0,0,0,0,0,0,0,60000,12000,0,72000,72000,0,72000
SA,Saudi Arabia,2022,0,0,0,0,0,0,0,0,60000,12600,0,72600,72600,0,72600
SA,Saudi Arabia,2023,0,0,0,0,0,0,0,0,66000,12000,0,78000,78000,0,78000
SF,South Africa,2017,0,0,0,0,0,0,0,0,19200,0,15900,35100,19200,15900,35100
SF,South Africa,2018,0,0,0,0,0,0,0,0,24000,0,18900,42900,24000,18900,42900
SF,South Africa,2019,0,0,0,0,0,0,0,0,21000,0,21600,42600,21000,21600,42600
SF,South Africa,2020,0,0,0,0,0,0,0,0,21000,0,18600,39600,21000,18600,39600
SF,South Africa,2021,0,0,0,0,0,0,0,0,18600,0,24300,42900,18600,24300,42900
SF,South Africa,2022,0,0,0,0,0,0,0,0,19500,0,27000,46500,19500,27000,46500
SF,South Africa,2023,0,0,0,0,0,0,0,0,21000,0,28500,49500,21000,28500,49500
SL,Sierra Leone,2017,0,3600,0,3600,2400,0,0,2400,0,0,0,0,1200,0,1200
SL,Sierra Leone,2018,0,3900,0,3900,2460,0,0,2460,0,0,0,0,1440,0,1440
SL,Sierra Leone,2019,0,3000,0,3000,2220,0,0,2220,0,0,0,0,780,0,780
SL,Sierra Leone,2020,0,3900,0,3900,2460,0,0,2460,0,0,0,0,1440,0,1440
SL,Sierra Leone,2021,0,4500,0,4500,3600,0,0,3600,0,0,0,0,900,0,900
SL,Sierra Leone,2022,0,3000,0,3000,2400,0,0,2400,0,0,0,0,600,0,600
SL,Sierra Leone,2023,0,3600,0,3600,3000,0,0,3000,0,0,0,0,600,0,600
SN,Singapore,2017,0,0,0,0,0,0,0,0,6300,0,0,6300,6300,0,6300
SN,Singapore,2018,0,0,0,0,0,0,0,0,5700,0,0,5700,5700,0,5700
SN,Singapore,2019,0,0,0,0,0,0,0,0,11400,0,0,11400,11400,0,11400
SN,Singapore,2020,0,0,0,0,0,0,0,0,6000,0,0,6000,6000,0,6000
SN,Singapore,2021,0,0,0,0,0,0,0,0,5400,0,0,5400,5400,0,5400
SN,Singapore,2022,0,0,0,0,0,0,0,0,5700,0,0,5700,5700,0,5700
SN,Singapore,2023,0,0,0,0,0,0,0,0,6000,0,0,6000,6000,0,6000
SZ,Switzerland,2017,0,0,0,0,0,69000,0,69000,156000,0,0,156000,87000,0,87000
SZ,Switzerland,2018,0,0,0,0,0,73500,0,73500,165000,0,0,165000,91500,0,91500
SZ,Switzerland,2019,0,0,0,0,0,81000,0,81000,168600,0,0,168600,87600,0,87600
SZ,Switzerland,2020,0,0,0,0,0,93600,0,93600,181800,0,0,181800,88200,0,88200
SZ,Switzerland,2021,0,0,0,0,0,112200,0,112200,207000,0,0,207000,94800,0,94800
SZ,Switzerland,2022,0,0,0,0,0,105000,0,105000,201000,0,0,201000,96000,0,96000
SZ,Switzerland,2023,0,0,0,0,0,108000,0,108000,204000,0,0,204000,96000,0,96000
TD,Trinidad and Tobago,2017,0,0,0,0,0,0,0,0,0,0,0,0,0,0,0
TD,Trinidad and Tobago,2018,0,0,0,0,0,0,0,0,0,0,0,0,0,0,0
TD,Trinidad and Tobago,2019,0,0,0,0,0,0,0,0,0,0,0,0,0,0,0
TD,Trinidad and Tobago,2020,0,0,0,0,0,0,0,0,0,0,0,0,0,0,0
TD,Trinidad and Tobago,2021,0,0,0,0,0,0,0,0,0,0,0,0,0,0,0
TD,Trinidad and Tobago,2022,0,0,0,0,0,0,0,0,0,0,0,0,0,0,0
TD,Trinidad and Tobago,2023,0,0,0,0,0,0,0,0,0,0,0,0,0,0,0
TH,Thailand,2017,0,48000,0,48000,0,0,51000,51000,31800,3000,0,34800,13800,18000,31800
TH,Thailand,2018,0,42000,0,42000,0,0,39000,39000,33000,2100,0,35100,14100,24000,38100
TH,Thailand,2019,0,39000,0,39000,0,0,43800,43800,48000,3000,0,51000,14400,31800,46200
TH,Thailand,2020,0,42000,0,42000,0,0,54300,54300,55800,4500,0,60300,16500,31500,48000
TH,Thailand,2021,0,36000,0,36000,0,0,53100,53100,54000,2100,0,56100,13500,25500,39000
TH,Thailand,2022,0,39000,0,39000,0,0,54000,54000,57000,3000,0,60000,13500,31500,45000
TH,Thailand,2023,0,42000,0,42000,0,0,60000,60000,54000,3000,0,57000,12000,27000,39000
TO,Togo,2017,0,4800,0,4800,4800,0,0,4800,0,0,0,0,0,0,0
TO,Togo,2018,0,7800,0,7800,7800,0,0,7800,0,0,0,0,0,0,0
TO,Togo,2019,0,5700,0,5700,5700,0,0,5700,0,0,0,0,0,0,0
TO,Togo,2020,0,6000,0,6000,6000,0,0,6000,0,0,0,0,0,0,0
TO,Togo,2021,0,5100,0,5100,5100,0,0,5100,0,0,0,0,0,0,0
TO,Togo,2022,0,2400,0,2400,2400,0,0,2400,0,0,0,0,0,0,0
TO,Togo,2023,0,3000,0,3000,3000,0,0,3000,0,0,0,0,0,0,0
TU,Turkey,2017,0,0,0,0,0,0,0,0,54000,3600,0,57600,57600,0,57600
TU,Turkey,2018,0,0,0,0,0,0,0,0,48000,3900,0,51900,51900,0,51900
TU,Turkey,2019,0,0,0,0,0,0,0,0,68400,3900,0,72300,72300,0,72300
TU,Turkey,2020,0,0,0,0,0,0,0,0,69900,3000,0,72900,72900,0,72900
TU,Turkey,2021,0,0,0,0,0,0,0,0,66300,3600,0,69900,69900,0,69900
TU,Turkey,2022,0,0,0,0,0,0,0,0,72000,3000,0,75000,75000,0,75000
TU,Turkey,2023,0,0,0,0,0,0,0,0,75000,3000,0,78000,78000,0,78000
TW,Taiwan,2017,0,0,0,0,0,0,0,0,27900,6300,0,34200,34200,0,34200
TW,Taiwan,2018,0,0,0,0,0,0,0,0,28200,7200,0,35400,35400,0,35400
TW,Taiwan,2019,0,0,0,0,0,0,0,0,30000,6600,0,36600,36600,0,36600
TW,Taiwan,2020,0,0,0,0,0,0,0,0,35400,6000,0,41400,41400,0,41400
TW,Taiwan,2021,0,0,0,0,0,0,0,0,33600,6000,0,39600,39600,0,39600
TW,Taiwan,2022,0,0,0,0,0,0,0,0,33000,6000,0,39000,39000,0,39000
TW,Taiwan,2023,0,0,0,0,0,0,0,0,34500,6000,0,40500,40500,0,40500
TZ,Tanzania,2017,33000,30000,0,63000,60000,0,1800,61800,0,0,0,0,3000,0,3000
TZ,Tanzania,2018,36000,33000,0,69000,60000,0,1800,61800,0,0,0,0,3000,0,3000
TZ,Tanzania,2019,42000,36000,0,78000,72000,0,1800,73800,0,0,0,0,3000,0,3000
TZ,Tanzania,2020,39000,36000,0,75000,72000,0,1800,73800,0,0,0,0,3000,0,3000
TZ,Tanzania,2021,42000,39000,0,81000,63000,0,420,63420,0,0,360,360,3000,1500,4500
TZ,Tanzania,2022,39000,33000,0,72000,69000,0,420,69420,0,0,480,480,3000,1500,4500
TZ,Tanzania,2023,37500,31500,0,69000,63000,0,420,63420,0,0,480,480,3000,1500,4500
UG,Uganda,2017,66000,226500,0,292500,276000,0,0,276000,0,0,0,0,15000,0,15000
UG,Uganda,2018,72000,204000,0,276000,258000,0,0,258000,0,0,0,0,15000,0,15000
UG,Uganda,2019,63000,216000,0,279000,267000,0,0,267000,0,0,0,0,15000,0,15000
UG,Uganda,2020,61500,267000,0,328500,321000,0,0,321000,0,0,0,0,6000,0,6000
UG,Uganda,2021,43800,354000,0,397800,390840,0,0,390840,0,0,0,0,6000,0,6000
UG,Uganda,2022,57000,318000,0,375000,367200,0,0,367200,0,0,0,0,7500,0,7500
UG,Uganda,2023,54000,345000,0,399000,391200,0,0,391200,0,0,0,0,9000,0,9000
UK,United Kingdom,2017,0,0,0,0,0,0,0,0,159000,29400,69600,258000,188400,69600,258000
UK,United Kingdom,2018,0,0,0,0,0,0,0,0,173400,37200,16500,227100,210600,16500,227100
UK,United Kingdom,2019,0,0,0,0,0,0,0,0,190500,42000,7200,239700,232500,7200,239700
UK,United Kingdom,2020,0,0,0,0,0,0,0,0,158400,37800,36600,232800,196200,36600,232800
UK,United Kingdom,2021,0,0,0,0,0,0,0,0,136200,31500,6300,174000,167700,6300,174000
UK,United Kingdom,2022,0,0,0,0,0,0,0,0,150000,39000,15600,204600,189000,15600,204600
UK,United Kingdom,2023,0,0,0,0,0,0,0,0,156000,36000,15000,207000,192000,15000,207000
UP,Ukraine,2017,0,0,0,0,0,0,0,0,15600,15600,26400,57600,31200,26400,57600
UP,Ukraine,2018,0,0,0,0,0,0,0,0,24000,16800,25500,66300,40800,25500,66300
UP,Ukraine,2019,0,0,0,0,0,0,0,0,25200,21600,21900,68700,46800,21900,68700
UP,Ukraine,2020,0,0,0,0,0,0,0,0,25200,27000,24000,76200,52200,24000,76200
UP,Ukraine,2021,0,0,0,0,0,0,0,0,26700,27600,19800,74100,54300,19800,74100
UP,Ukraine,2022,0,0,0,0,0,0,0,0,15000,19500,18000,52500,34500,18000,52500
UP,Ukraine,2023,0,0,0,0,0,0,0,0,15000,18000,18000,51000,33000,18000,51000
US,United States,2017,1980,0,0,1980,0,0,0,0,1548600,9600,30000,1588200,1500720,30000,1530720
US,United States,2018,1920,0,0,1920,0,0,0,0,1467000,6900,12600,1486500,1520820,12600,1533420
US,United States,2019,3240,0,0,3240,0,0,0,0,1629000,22200,30000,1681200,1599720,30000,1629720
US,United States,2020,2340,0,0,2340,0,0,0,0,1434000,21600,48000,1503600,1514940,48000,1562940
US,United States,2021,1980,0,0,1980,0,0,0,0,1460100,36300,35100,1531500,1521120,35100,1556220
US,United States,2022,2280,0,0,2280,0,0,0,0,1500000,33000,60000,1593000,1524660,60000,1584660
US,United States,2023,2400,0,0,2400,0,0,0,0,1530000,36000,60000,1626000,1560000,48000,1608000
VE,Venezuela,2017,31800,0,0,31800,480,0,0,480,36000,60,60,36120,67920,60,67980
VE,Venezuela,2018,34500,0,0,34500,480,0,0,480,39000,60,60,39120,72960,60,73020
VE,Venezuela,2019,35100,0,0,35100,960,0,0,960,39000,60,60,39120,72780,60,72840
VE,Venezuela,2020,33000,0,0,33000,300,0,0,300,0,60,60,120,33300,60,33360
VE,Venezuela,2021,28800,0,0,28800,300,0,0,300,0,60,60,120,27900,60,27960
VE,Venezuela,2022,30000,0,0,30000,300,0,0,300,0,60,60,120,29700,60,29760
VE,Venezuela,2023,30000,0,0,30000,300,0,0,300,0,60,60,120,30000,60,30060
VM,Vietnam,2017,66000,1536000,0,1602000,1434000,33000,120000,1587000,30000,20400,9600,60000,144000,22200,166200
VM,Vietnam,2018,61560,1696440,0,1758000,1635420,33000,126000,1794420,30000,24000,9600,63600,150000,22800,172800
VM,Vietnam,2019,63840,1760160,0,1824000,1537080,33000,129000,1699080,30000,30000,9600,69600,153000,23400,176400
VM,Vietnam,2020,66000,1812000,0,1878000,1471560,33000,135000,1639560,18000,18000,6000,42000,156000,30000,186000
VM,Vietnam,2021,57000,1683000,0,1740000,1347000,33000,138000,1518000,15000,12000,6000,33000,156000,30000,186000
VM,Vietnam,2022,66000,1830000,0,1896000,1560000,33000,141000,1734000,18000,12000,6000,36000,157200,31200,188400
VM,Vietnam,2023,66000,1788000,0,1854000,1500000,36000,150000,1686000,16500,12000,6000,34500,162600,35400,198000
YM,Yemen,2017,0,0,0,0,0,0,0,0,0,0,0,0,0,0,0
YM,Yemen,2018,0,0,0,0,0,0,0,0,0,0,0,0,0,0,0
YM,Yemen,2019,0,0,0,0,0,0,0,0,0,0,0,0,0,0,0
YM,Yemen,2020,0,0,0,0,0,0,0,0,0,0,0,0,0,0,0
YM,Yemen,2021,0,0,0,0,0,0,0,0,0,0,0,0,0,0,0
YM,Yemen,2022,0,0,0,0,0,0,0,0,0,0,0,0,0,0,0
YM,Yemen,2023,0,0,0,0,0,0,0,0,0,0,0,0,0,0,0
ZA,Zambia,2017,0,0,0,0,0,0,0,0,0,0,0,0,0,0,0
ZA,Zambia,2018,0,0,0,0,0,0,0,0,0,0,0,0,0,0,0
ZA,Zambia,2019,0,0,0,0,0,0,0,0,0,0,0,0,0,0,0
ZA,Zambia,2020,0,0,0,0,0,0,0,0,0,0,0,0,0,0,0
ZA,Zambia,2021,0,0,0,0,0,0,0,0,0,0,0,0,0,0,0
ZA,Zambia,2022,0,0,0,0,0,0,0,0,0,0,0,0,0,0,0
ZA,Zambia,2023,0,0,0,0,0,0,0,0,0,0,0,0,0,0,0
